10 10
3
4 4
##########
#FFF_....#
#FFF_..T.#
#FFF_....#
#________#
#..._....#
#~~~_....#
#~T~_....#
#~~~_....#
##########
