15 27
8 1
3
30
###############
#FFF~.._..~FFF#
#FF~..._...~FF#
#F~...._....~F#
#~....._.....~#
#......_......#
#....FF_FF....#
#....FF_FF....#
#......_......#
#~....._.....~#
#F~...._....~F#
#FF~..._...~FF#
#FFF~.._..~FFF#
#FF~..._...~FF#
#F~...._....~F#
#~....._.....~#
#......_......#
#.#####_#####.#
#.#.........#.#
#.#.#######.#.#
#.#.#F...F#.#.#
#.#.#.#.#.#.#.#
#.#.#.#T#.#.#.#
#.#...###...#.#
#.#####F#####.#
#.~~~.FFF.~~~.#
###############
