35 35
17 17
10
50
###################################
#.................................#
#..........T.T.....T.T............#
#########...............###########
#.......#####........####.........#
#...........###._.###.............#
#..............._.................#
#.............~~_~~...............#
#.............~~_~~...............#
#.............~~_~~...............#
#.............~~_~~...............#
#.............~~_~~...............#
#..F..........~~_~~...............#
#..FFF.F...~~~~~_~~~~.............#
#.FFFFF...~~~~~~_~~~~~~......FFFF.#
#..F...F..~~~~~...~~~~~....FFF..FF#
#.....FF..~~~~..T..~~~~....F..F..F#
#.........~~~~.T.T.~~~~...........#
#.........~~~~..T..~~~~....FFFFFF.#
#.FFFFF...~~~~~...~~~~~....F.FF...#
#...F.FF..~~~~~~_~~~~~~...........#
#...........~~~~_~~~~.............#
#.............~~_~~...............#
#.............~~_~~...............#
#.............~~_~~...............#
#.............~~_~~...............#
#.............~~_~~...............#
#.............~~_~~...............#
#..............._.................#
#...........###...###.............#
#........####.......####..........#
##########.............############
#.........T.T......T.T............#
#.................................#
###################################
