10 9
5 4
10
20
##########
#FFF_....#
#FFF_..T.#
#FFF_....#
#..._....#
#~~~_....#
#~T~_..###
#~~~_..#.#
##########
