20 20
10 10
5
20
####################
#._.....FF.FF......#
#._.....FFFF.FF....#
#._.~~~~..F.FF.....#
#._....__......._..#
#._.T.____...T.._..#
#._.___..___...__..#
#._.._..T..__.._...#
#._.._..T..._.._...#
#._.._..T~~._.T_...#
#._.._.T...._.._...#
#._.._..~~~._.._...#
#._.._..~~T.__._...#
#._..__.~~~~._._...#
#._...__.T..._._...#
#.__..._.....___...#
#..__.._...........#
#....___..~~~~~~...#
#...........~~~~~~.#
####################
